*******************************
*..........................*..*
*..****.....*..*..*..*.....*..*
*..*.....*..*..*..*.....*.....*
*..*.....*..*..*..*...........*
*..*...........*..*..*........*
*.......................*..*..*
*..****..*..*.....***......*..*
*..*.....*..*..*........*....**
*...........*..*..*...........*
*..*..*..*........*...*....****
*..*..*........*........*.....*
*.....*.............*...*..*..*
*...........*..*..*........*..*
*.....**.*.....*..*...........*
*..*........*.....*.....*.....*
*..*..*..*.....*..*.....*.....*
*...........*..*........*.....*
*........*..*..*...........*..*
*..*.....***......*...........*
*******************************