************************************************************
*.......................*.......................*..*.......*
*.....*..**.............*..*.....****..****..*..*..*..****.*
*.................*........*....................*.....*....*
*.................*.......................*................*
*.....*..*..............*........*..*..*.....*........*....*
*.....*..*..****........*..*..****..*..****..****..*..*....*
*.............****.**......**..............................*
***........................................................*
*...............................*.*......*.................*
*.....*.................*.....*...........*..*..*..*.......*
*..*..*..***............*..*..*....**........*..*..*.......*
*..*.....*........*..*.....*..*.................*..........*
*.................*..*....*................................*
*..*..*..*...........*..*........*..*..*.....*........*....*
*..*..*..*..***......*..*.....****..*..****..****..*..*....*
*................*...*.....................................*
*..........................................................*
*..............................*******.....................*
*.....*..*..............*........*........*..*..*..*.......*
*..*..*..*...........*..*..*.....****..****..*..*..*.......*
*........*........*..*.....*....................*.....**...*
*.................*..*...................................***
*..*..*..*...........*..*........*..*..*.................***
*.....*..*..***...............****..*...........*..*.......*
*.............*...................................*........*
************************************************************